111111111111111111111111111111111111111111111111
1E0000000000000000000000000000000000000000000001
100000C000000000000000000000000000000C0000000001
100000000000000000000000000000000000000000000001
100000000000100001111000011110000000010000000001
100000000001100001001000010010000100100000000001
100000000000100001001000010010000001000000000001
100000000000100001001000010010000010010000000001
100000000000100001111000011110000100000000000001
100000000000000000000000000000000000000000000001
100000000000000000000000000000000000000000000001
1000000C000000000000000000000C0000000000C0000001
1000000000000000000C0000000000000000000000000001
10000000000000000000000000000C000000000000000001
100000000000000000000000000000000000000000000001
100000C00000000000000000000000000C000000000000P1
111111111111111111111111111111111111111111111111