111111111111111111111111111111111111111111111111
1E0000000000000000000000000000000000000000000001
100000C000000000000000000000000000000C0000000001
100000000000000000000000000000000000000000000001
100000000000100000111000001110000111000000000001
100000000001100000001000000010000001000000000001
100000000000100000111000001110000001000000C00001
100000000000100000001000000010000001000000000001
100000000001110000111000001110000001000000000001
100000000000000000000000000000000000000000000001
100000000000000000000000000000000000000000000001
1000000000000000000000000000000000000000C0000001
100000000001010000111000001110000111000000000001
100000000001010000101000001000000101000000000001
100000000001010000101000001110000111000000000001
100000C000010100001010000010100001000000000000C1
100000000001110000101000001110000100000000000001
100000000000000000000000000000000000000000000001
100000000000000000000000000000000000000000000001
100000000000000000000000000000000000000000000001
10000000C000000000000000000000000000C00000000001
1000000000000000000C0000000000000000000000000001
100000000000000000000000000000000000000000000001
1000000000000000000000000000000000000000000000P1
111111111111111111111111111111111111111111111111